1110000000
0000000000
0000000000
0000000000
0000011100
0000000000
0000000011
0000000000
0000000000
0000000000
0000000000
0000000000
0000000000
0000000000
0000000000
0000000000
1111111111
1111111111