0000000000
0001110000
0000000000
0000000000
1110000011
0000000000
0000000000
0000001111
0000000000
0000000000
0000111000
0000000000
0000000000
0000000111
0000000000
0000000000
1111111111
1111111111