1000000000000000000000000000000000000000000000000000000000000000000000
1001000000000000000000000000000000000000000000000000000000000000000000
1000000011100000000000000000000000000000000000000000000000000000000000
1001000000000000000000000000000000000000000000000000000000000000000000
1000000000000001111100000000000000000000000000000000000000000000000000
1001000000000000000000000000000000000000000000000000000000000000000000
1001000011100000000000000000000000000000000000000000000000000000000000
0000000000000000000000000000000000000000000000000000000000000000000000
1111111111111111111111111111111111111111111111111111111111111111111111