0000000000
0000011100
0000000000
0000000000
0111100001
0000000000
0000000000
0000011110
0000000000
0000000000
0001100000
0000000000
0000000000
0000001110
0000000000
0000000000
1111111111
1111111111