00000000000000000000
00000000000000000000
11100000000000000000
00000000000000000111
00000000010000000000
00000000000000000000
00000000000000000000
00011100000000000111
00000000000000000000
00000000000000000000
00000000011100000000
00000000000000000000
00000000000000000000
00011100000000000000
00000000000000000000
00000000000000000000
11111111111111111111
11111111111111111111